```
	╔════════════════════════════════════════════════════════╗
	║                                                        ║ 
	║                                                        ║ 
	║     🐢                                 🐢             ║ 
	║════════════════════                ════════════════════║ 
	║                                                        ║ 
	║                                                        ║ 
	║                                                        ║ 
	║     🐢                 🐢                             ║ 
	║═══════════           ════════════           ═══════════║ 
	║                                                        ║ 
	║                                                        ║ 
	║                                                        ║ 
	║               🐢                                  🐢  ║ 
	║════════════════════                ════════════════════║    
	║                               ╔ ╗                      ║ 
	║                               ╚ ╝                      ║
	║▄                              ツ                      ▄║ 
	╚════════════════════════════════════════════════════════╝ 
```
